4 1 1 1 1 1 1 1 1 1
0 1 1 0 0 0 3 0 0 4
2 1 1 0 1 0 1 0 1 0
0 0 4 0 3 4 0 0 3 0
0 1 1 0 1 1 1 1 1 0
0 0 4 0 1 1 0 0 0 0
4 1 1 1 1 1 0 1 1 1
0 1 0 0 0 1 0 0 0 1
0 1 0 1 0 1 1 1 0 1
5 0 0 1 0 0 0 0 4 1